start in 2
0 -> 1 9
0 -> 2 4
0 -> 3 3
0 -> 4 5
1 -> 2 7
1 -> 3 8
1 -> 4 10
2 -> 3 2
2 -> 4 1
3 -> 4 6
